"filename", "language", "Java", "YAML", "XML", "Markdown", "Batch", "comment", "blank", "total"
"d:\java_project\system-design\short-url\README.md", "Markdown", 0, 0, 0, 26, 0, 0, 9, 35
"d:\java_project\system-design\short-url\mvnw.cmd", "Batch", 0, 0, 0, 0, 96, 51, 36, 183
"d:\java_project\system-design\short-url\pom.xml", "XML", 0, 0, 75, 0, 0, 0, 6, 81
"d:\java_project\system-design\short-url\src\main\java\com\wendy\ShortUrlApplication.java", "Java", 9, 0, 0, 0, 0, 0, 5, 14
"d:\java_project\system-design\short-url\src\main\java\com\wendy\controller\ShortUrlController.java", "Java", 19, 0, 0, 0, 0, 6, 6, 31
"d:\java_project\system-design\short-url\src\main\java\com\wendy\dao\UrlMapRepository.java", "Java", 9, 0, 0, 0, 0, 6, 2, 17
"d:\java_project\system-design\short-url\src\main\java\com\wendy\entity\LongUrl.java", "Java", 6, 0, 0, 0, 0, 6, 3, 15
"d:\java_project\system-design\short-url\src\main\java\com\wendy\po\UrlMapPo.java", "Java", 18, 0, 0, 0, 0, 6, 6, 30
"d:\java_project\system-design\short-url\src\main\java\com\wendy\service\ShortUrlService.java", "Java", 6, 0, 0, 0, 0, 16, 3, 25
"d:\java_project\system-design\short-url\src\main\java\com\wendy\service\impl\ShortUrlServiceImpl.java", "Java", 72, 0, 0, 0, 0, 13, 15, 100
"d:\java_project\system-design\short-url\src\main\java\com\wendy\utils\BloomFilterUtils.java", "Java", 44, 0, 0, 0, 0, 41, 16, 101
"d:\java_project\system-design\short-url\src\main\java\com\wendy\utils\DecimalTo62Utils.java", "Java", 33, 0, 0, 0, 0, 6, 8, 47
"d:\java_project\system-design\short-url\src\main\java\com\wendy\utils\RedisClientUtils.java", "Java", 307, 0, 0, 0, 0, 195, 58, 560
"d:\java_project\system-design\short-url\src\main\resources\application.yml", "YAML", 0, 16, 0, 0, 0, 0, 1, 17
"d:\java_project\system-design\short-url\src\test\java\com\wendy\utils\DecimalTo62UtilsTest.java", "Java", 10, 0, 0, 0, 0, 0, 4, 14
"Total", "-", 533, 16, 75, 26, 96, 346, 178, 1270